▓▓▓▓▓▓▓▓▓▓▓▓▓▓▓▓▓▓▓▓▓▓▓▓▓▓▓▓▓▓▓▓▓▓▓▓▓▓▓▓▓▓▓▓▓▓▓▓▓▓▓▓▓▓▓▓▓▓▓▓▓▓▓▓▓▓▓▓▓▓▓▓▓▓
▓                                                                        ▓
▓  ▓   ▓   ▓▓▓    ▓▓▓▓    ▓▓▓▓     ▓   ▓▓▓▓▓    ▓        ▓               ▓
▓  ▓   ▓  ▓   ▓   ▓▓      ▓   ▓    ▓     ▓     ▓ ▓       ▓               ▓
▓  ▓▓▓▓▓  ▓   ▓     ▓▓    ▓▓▓▓     ▓     ▓    ▓▓▓▓▓      ▓               ▓
▓  ▓   ▓  ▓   ▓      ▓    ▓        ▓     ▓   ▓     ▓     ▓               ▓
▓  ▓   ▓   ▓▓▓    ▓▓▓     ▓        ▓     ▓  ▓       ▓    ▓▓▓▓▓           ▓
▓                                                                        ▓
▓                                                                        ▓
▓▓▓▓▓▓▓▓▓▓▓▓▓▓▓▓▓▓▓▓▓▓▓▓▓▓▓▓▓▓▓▓▓▓▓▓▓▓▓▓▓▓▓▓▓▓▓▓▓▓▓▓▓▓▓▓▓▓▓▓▓▓▓▓▓▓▓▓▓▓▓▓▓▓
▓                                   ▓                  ▓                  
▓                                    ▓                 ▓                  
▓                                     ▓                ▓                  
▓                                      ▓               ▓                  
▓                                       ▓              ▓      █████        
▓                                        ▓             ▓     ███████     
▓                                         ▓            ▓    █ ◉ ◉  █       
▓                                          ▓▓▓▓▓▓▓▓▓▓▓▓▓    █      █       
▓                                                      █     ██ ███       
▓                                                      ██████  █   █      
▓                                                      ██████  █ █ █      
▓                                          ▓▓▓▓▓▓▓▓▓▓▓▓▓    █    █ █      
▓                                         ▓            ▓    █    █ █      
▓                                        ▓             ▓    █   ████      
▓                                       ▓              ▓    █   █  █      
▓                                      ▓               ▓    ██   ██       
▓                                     ▓                ▓     █████        
▓                                    ▓                 ▓     ██  ██       
▓                                   ▓                  ▓     ██  ██       
▓▓▓▓▓▓▓▓▓▓▓▓▓▓▓▓▓▓▓▓▓▓▓▓▓▓▓▓▓▓▓▓▓▓▓▓▓▓▓▓▓▓▓▓▓▓▓▓▓▓▓▓▓▓▓▓    ███ ███
