███████████████████████████████████████████████████████████████                                                                          
                                                              █            
   █          ████  █      ████   ███       █   █     █████   █            
    █        ██     █     █      █   █     █ █ █ █    █       █            
     █  ██  █ ████  █     █      █   █    █   █   █   █████   █            
      █ ██ █  █     █     █      █   █   █         █  █       █            
       █  █   ████  █████  ████   ███   █           █ █████   █            
                                                              █            
                                                              █            
                            █     █  █                        █            
                            █    ██ █                         █            
                            █   █ ██                          █            
                            █  █  █                           █            
                                                              █            
                                                              █           
   █    █   ███   ████  ████   █ ████████    █     █          █            
   █    █  █   █ █      █   █  █    █       █ █    █          █            
   ██████  █   █  ███   █████  █    █      █████   █          █            
   █    █  █   █     █  █      █    █     █     █  █          █            
   █    █   ███  █████  █      █    █    █       █ █████      █            
                                                              █            
                                                              █            
                 ████   ████   ████      █      █   █         █            
                 █   █  █   █  █        █ █     █  █          █            
                 ████   █████  ████    █   █    █ █           █            
                 █   █  █  █   █      ███████   ██ █          █            
                 █    █ █   █  █     █       █  █   █         █            
                 █████  █    █ ████ █         █ █    █        █            
                                                              █            
                                                              █            
███████████████████████████████████████████████████████████████
